Amazonas : Leticia
Antioquia : Medellín
Arauca : Arauca
Atlántico : Barranquilla
Bolívar : Cartagena de Indias
Boyacá : Tunja
Caldas : Manizales
Caquetá : Florencia
Casanare : Yopal
Cauca : Popayán
Cesar : Valledupar
Chocó : Quibdó
Córdoba : Montería
Cundinamarca : Bogotá
Guainía : Inírida
Guaviare : San José del Guaviare
Huila : Neiva
La Guajira : Riohacha
Magdalena : Santa Marta
Meta : Villavicencio
Nariño : San Juan de Pasto
Norte de Santander : San José de Cúcuta
Putumayo : Mocoa
Quindío : Armenia
Risaralda : Pereira
San Andrés y Providencia : San Andrés
Santander : Bucaramanga
Sucre : Sincelejo
Tolima : Ibagué
Valle del Cauca : Cali
Vaupés : Mitú
Vichada : Puerto Carreño
